1131111111111
1555555522211
1511511111211
1515515551211
1515155151211
1515151151111
1511155151111
1511115151511
1555555155511
1111111111511
1255555555511
1114111111111
---
length = 51
time = 52
