1131111111111
1552222222211
1511211111211
1512215551211
1512155151211
1512151151111
1511155151111
1511115151211
1555555155511
1111111111511
1255555555511
1141111111111
---
length = 40
time = 1479
